+-+-+-+-+-+
    |     |
+-+ + +-+ +
|     |   |
+ +-+-+ +-+
| |     | |
+ + +-+-+ +
| | |     |
+ + + + --+
| |   |    
+-+-+-+-+-+