+-+-+-+-+-+
|   |     |
+-+ + +-+ +
|     |   |
+ +-+-+ +-+
| |     | |
+ + +-+-+ +
| | |     |
+ + + + --+
| |   |    
+-+-+-+-+-+