+-+-+-+-+-+-+-+-+-+-+-+-+-+-+-+-+-+-+-+-+
|   | |   |   |           |   |     |   |
+ + + + + + + + +-+-+-+-+ +-+ + +-+ +-+ +
| |     | | |   |         |   | |       |
+ +-+-+-+ + +-+-+ +-+-+-+-+ +-+ +-+-+-+ +
|       |   |   | |       |   | |       |
+-+-+-+ +-+ + + + + +-+-+ + + + + +-+-+-+
|   |   |   | | | | |     | |   |       |
+ + +-+-+ +-+ + + + + +-+-+ + +-+-+-+-+ +
| |     |     | | | | |     | |   |     |
+ +-+-+ +-+-+-+ + + + + +-+-+ + + + +-+-+
| |   | |   |   | | | | |     | | | |   |
+ +-+ + +-+ + +-+ + + + + +-+-+-+ +-+ + +
| |   |   |   |   | | | |   |   | |   | |
+ + +-+-+ +-+-+ +-+ + + +-+ + + + + +-+ +
| | | |   |     |   | | |   | | |   |   |
+ + + + +-+ +-+-+ +-+ + + +-+ + +-+-+-+ +
|   | |       |   |   | |     |         |
+-+-+ +-+-+ + + +-+ +-+ +-+-+-+ +-+-+ +-+
|     |     |     |     |   |   |   | | |
+ +-+-+ +-+-+-+-+-+-+-+-+-+ +-+-+ +-+ + +
|     | |   |     |   |     |     |     |
+ +-+ + + + +-+-+ + + + +-+ + +-+ + +-+-+
|   | |   |       | |   | |   |     |   |
+-+ + + +-+-+ +-+-+ + +-+ +-+ + + +-+ + +
|   |   |   | |     | |   |   | |   | | |
+ +-+-+-+-+ +-+ +-+-+-+ +-+ +-+ +-+ + + +
|         | |   |       |   |   |   | | |
+-+-+-+-+ + + +-+ +-+-+-+-+-+ +-+ +-+ + +
| |   |   | |   |         |     | |   | |
+ + + + +-+ +-+ +-+-+-+-+ +-+-+ + + +-+ +
|   |   | |     |   |   |     | |   |   |
+ +-+-+-+ +-+-+-+ + + + +-+-+ + +-+-+ +-+
|   |       |   | |   |     |   |   | | |
+-+ + +-+-+ +-+ + +-+-+-+-+ +-+-+-+ + + +
|   |     |   | | |   | |     |     |   |
+ +-+-+-+ +-+ + + + + + + + + + + +-+-+ +
| |   |   |   | | | | |   | | | |     | |
+ + + + +-+-+ + + + +-+ + + +-+ + +-+-+ +
|   |   |     |   |     | |     |        
+-+-+-+-+-+-+-+-+-+-+-+-+-+-+-+-+-+-+-+-+