+-+-+-+-+-+-+-+-+-+-+
|   | |   |       | |
+ + + + + + +-+-+ + +
| |     |   |   |   |
+ +-+-+-+-+-+ + +-+-+
| |   |   |   | |   |
+ + + +-+ + +-+ +-+ +
|   |   |   |     | |
+-+-+-+ + +-+-+-+ + +
|     | |       | | |
+ +-+-+ +-+-+-+ + + +
|   |     |     |   |
+ +-+ + + +-+ + +-+-+
| |   | |     | |   |
+ + +-+ +-+-+-+-+ + +
|   |   |         | |
+-+-+ +-+ +-+-+-+ + +
|   |     |     | | |
+ +-+ +-+-+ +-+ + +-+
|             | |    
+-+-+-+-+-+-+-+-+-+-+