*****E**
*   * **
* * * **
* * * **
* * * **
* * * **
*S*   **
********