***** **
*   *E**
* * * **
* * * **
* * * **
* * * **
*S*   **
********